SO ./texture/64x64/so.xpm
NO ./texture/64x64/no.xpm



C 173, 216, 270 
F 250,249,246
EA ./texture/64x64/ea.xpm


WE ./texture/64x64/we.xpm

11111111
1   1001
11111101
1100000111
10000001
10000001
10000001
11111111




11111111
1   1001
11111101
1100000111
10000N01
10000001
10000001
11111111