SO ./texture/32x32/so.xpm
NO ./texture/32x32/no.xpm



F 250,249,246
EA ./texture/32x32/ea.xpm


WE ./texture/32x32/we.xpm




C 173, 216, 230 








11111111
10000001
10100001
110W0001
10000001
10000001
10000001
11111111