SO ./path_to_the_south_texture
NO ./path_to_the_north_texture



F 220,100,0
EA ./path_to_the_east_texture


WE ./path_to_the_west_texture




C 225,30,0









11111111
10000001
10100001
110N0001
10000001
10000001
10000001
11111111