
SO ./texture/64x64/so.xpm
NO ./texture/64x64/no.xpm



C 255, 216, 255
EA ./texture/64x64/ea.xpm

F 250,249, 255
WE ./texture/64x64/we.xpm

1111111
10100101
11111101
1100000111
1000N001
10000001
10000001
11111111


