SO ./texture/64x64/so.xpm
NO ./texture/64x64/no.xpm



F 250,249,246
EA ./texture/64x64/ea.xpm


WE ./texture/64x64/we.xpm




C 173, 216, 230 




                        





              11111111
              10100001
11111111111111101000011
10000000000000000N000111
110000000000000000000011
110000000000000000000011
11000001111111111111111
10000001
10000001
10000001
11111111