




                 NO ./hjhjgjhgahjs




     
  
  
  
	             SO ./hjjsjkhjkhjkhk kjs
                 WE ./hjhsdjnds        kjhdjkshdjkshhjs
  
                 EA ./hjdskjdsklj             dklsjdlskjdklsjhjs                  


F               110, 230, 10
C               250, 150, 20





                        





              11111111
              10000001
1111111111111110100001
10000000000000000N0001
1100000111111111111111
10000001
10000001
10000001
11111111