SO ./texture/so.xpm
NO ./texture/no.xpm



F 250,249,246
EA ./texture/ea.xpm


WE ./texture/we.xpm




C 173, 216, 230 




                        





              11111111
              10000001
1111111111111110100001
10000000000000000W0001
1100000111111111111111
10000001
10000001
10000001
11111111