

                  

SO ./texture/64x64/so.xpm
NO ./texture/64x64/no.xpm



F 210,150,42
EA ./texture/64x64/ea.xpm








C 173, 216, 230 

WE ./texture/64x64/we.xpm



                   11111111111111
               1111100000000000011111
           111110000000000000000000011111
        1111000000000000000000000000000011111
      11100000000000000000000000000000000000111
    111000000000000000000000000000000000000000111
   11100000000000000000000000000000000000000000111
  1110000000000000000000000000000000000000000000111
 111000000000000000000000000000000000000000000000111
 111000000000000000000000000000000000000000000000111
 111000000000000000000000000000000000000000000000111
 111000000000000000000000000000000000000000000000111
 111000000000000000000000000000000000000000000000111
 111000000000000000000000000000000000000000000000111
 111000000000000000000000000000000000000000000000111
 111000000000000000000000000000000000000000000000111
 111000000000000000000000000000000000000000000000111
 111000000000000000000000000000000000000000000000111
 111000000000000000000000000000000000000000000000111
 111000000000000000000000000000000000000000000000111
 111000000000000000000000000000000000000000000000111
 111000000000000000000000000000000000000000000000111
 111000000000000000000000000000000000000000000000111
 111000000000000000000000000000000000000000000000111
 111000000000000000000000000000000000000000000000111
 111000000000000000000000000000000000000000000000111
 111000000000000000000000000000000000000000000000111
 111000000000000000000000000000000000000000000000111
 111000000000000000000000000000000000000000000000111
 111000000000000000000000000000000000000000000000111
 111000000000000000000000000000000000000000000000111
 111000000000000000000000000000000000000000000000111
 111000000000000000000000000000000000000000000000111
 111000000000000000000000000000000000000000000000111
 111000000000000000000000000000000000000000000000111
 111000000000000000000000000000000000000000000000111
 111000000000000000000000000000000000000000000000111
 111000000000000000000000000000000000000000000000111
 111000000000000000000000000000000000000000000000111
 111000000000000000000000000000000000000000000000111
 111000000000000000000000000000000000000000000000111
 111000000000000000000000000000000000000000000000111
 111000000000000000000000000000000000000000000000111
 111000000000000000000000000000000000000000000000111
 111000000000000000000000000000000000000000000000111
 111000000000000000000000000000000000000000000000111
 111000000000000000000000000000000000000000000000111
 111000000000000000000000000000000000000000000000111
 111000000000000000000000000000000000000000000000111
 111000000000000000000000000000000000000000000000111
 111000000000000000000000000000000000000000000000111
 111000000000000000000000000000000000000000000000111
 111000000000000000000000000000000000000000000000111
 111000000000000000000000000000000000000000000000111
 111000000000000000000000000000000000000000000000111
 111000000000000000000000000000000000000000000000111
 111000000000000000000000000000000000000000000000111
 111000000000000000000000000000000000000000000000111
 111000000000000000000000000000000000000000000000111
 111000000000000000000000000000000000000000000000111
 111000000000000000000000000000000000000000000000111
 111000000000000000000000000000000000000000000000111
 111000000000000000000000000000000000000000000000111
 111000000000000000000000000000000000000000000000111
 111000000000000000000000000000001000000000000000111
 111000000000000000000000000000000000000000000000111
 111000000000000000000000000000000000000000000000111
 111000000000000000000000000000000000000000000000111
 111000000000000000000000000000000000000000000000111
 111000000000000000000000000000000000000000000000111
 111000000000000000000000000000000000000000000000111
 111000000000000000000000000000000000000000000000111
 111000000000000000000000000000000000000000000000111
 111000000000000000000000000000000000000000000000111
 111000000000000000000000000000000000000000000000111
 111000000000000000000000000000000000000000000000111
 111000000000000000000000000000000000000000000000111
 111000000000000000000000000000000000000000000000111
 111000000000000000000000000000000000000000000000111
 111000000000000000000000000000000000000000000000111
 111000000000000000000000000000000000000000000000111
 111000000000000000000000000000000000000000000000111
 111000000000000000000000000000000000000000000000111
 111000000000000000000000000000000000000000000000111
 111000000000000000000000000000000100000000000000111
 111000000000000000000000000000000000000000000000111
 111000000000000000000000000000010N01000000000000111
 111000000000000000000000000000000000000000000000111
 111000000000000000000000000000000100000000000000111
 111000000000000000000000000000000000000000000000111
  1110000000000000000000000000000000000000000000111
   11100000000000000000000000000000000000000000111
    111000000000000000000000000000000000000000111
      11100000000000000000000000000000000000111
        1111000000000000000000000000000001111
           1111100000000000000000000011111
               11111000000000000011111
                   111111111111111
